"Year","Tows","All_Fish","Sexed_Fish","Unsexed_Fish","Sample_Size"
2003,249,1052,1049,3,605
2004,190,775,773,2,461
2005,265,940,939,1,643
2006,203,705,705,0,493
2007,227,657,657,0,551
2008,217,628,494,134,527
2009,236,693,688,5,573
2010,256,773,714,59,622
2011,238,467,463,4,578
2012,250,678,674,4,607
2013,175,593,564,29,425
2014,254,520,519,1,617
